1111111111111111111111111111111111111111
1P00000000000000000001111111111111111111
1000000000000000000010000000000000000001
1000000000000000000010000000000000000001
1000000000000000000010000000000000000001
1000000000000000000010000000000000000001
1000000000000000000010000000000000000001
1000000000000000000010000000000000000001
1000000000000000000010000000000000000001
1000000000000000000010000000000000000001
1000000000000000000010000000000000000001
1000000000000000000010000000000000000001
1000000000000000000010000000000000000001
1000000000000000000010000000000000000001
1000000000000000000010000000000000000001
1000000000000000000010000000000000000001
1000000000000000000010000000000000000001
1000000000000000000010000000000000000001
1000000000000000000000000000C000000000E1
1111111111111111111111111111111111111111
