1111111111111
10010000000C1
1000011111001
1P0011E000001
1111111111111
1000000000001
1001111001101
1C00000E00001
1111111111111
10010000000C1
1000011111001
1P0011E000001
1111111111111
1000000000001
1001111001101
1C00000E00001
1111111111111
10010000000C1
1000011111001
1P0011E000001
1111111111111
